{
    "levels":[
    [
        [0,0,0,0,0,0,0,0,0,0,0,0,0,0,0,0],
        [0,0,0,0,0,0,0,0,0,0,0,0,0,0,0,0],
        [0,0,0,0,0,0,0,0,0,0,0,0,0,0,0,0],
        [0,0,0,0,0,0,0,0,0,0,0,0,0,0,0,0],
        [0,0,0,0,0,0,0,0,0,0,0,0,0,0,0,0],
        [0,0,0,0,0,0,0,0,0,0,0,0,0,0,0,0],
        [0,0,0,0,0,0,0,0,0,0,0,0,0,0,0,0],
        [0,0,0,16,17,17,18,0,0,0,0,0,0,0,0,0],
        [0,0,0,0,0,0,0,0,0,0,0,0,16,17,17,18],
        [0,0,0,0,0,0,0,0,0,0,0,0,0,0,0,0],
        [0,0,0,0,0,0,0,0,0,0,0,0,0,0,0,0],
        [1,2,2,2,2,2,2,2,2,2,2,2,2,2,2,3]
    ],
    [
        [0,0,0,0,0,0,0,0,0,0,0,0,0,0,0,0],
        [0,0,0,0,0,0,0,0,0,0,0,0,0,0,0,0],
        [0,0,0,0,0,0,0,0,0,0,0,0,0,0,0,0],
        [0,0,0,0,0,0,0,0,0,0,0,0,0,0,0,0],
        [0,0,0,0,0,0,0,0,0,0,19,20,20,20,20,21],
        [0,0,0,19,20,20,21,0,0,0,0,0,0,0,0,0],
        [0,0,0,0,0,0,0,0,19,20,21,0,0,0,0,0],
        [0,0,0,0,0,0,0,0,0,0,0,0,0,0,0,0],
        [0,0,0,0,0,0,0,0,19,20,21,0,0,0,0,0],
        [0,0,0,19,20,21,0,0,0,0,0,0,0,0,0,0],
        [0,0,0,0,0,0,0,0,0,0,0,0,0,0,0,0],
        [10,11,11,12,0,10,11,11,11,12,0,10,11,11,11,12]
    ],
    [
        [0,0,0,0,0,0,0,0,0,0,0,0,0,0,0,0],
        [0,0,0,0,0,0,0,0,0,0,0,0,0,0,0,0],
        [0,0,0,0,0,0,0,0,0,0,0,0,0,0,0,0],
        [0,0,0,0,0,0,0,0,0,0,0,0,0,0,0,0],
        [0,0,0,0,0,0,0,0,0,0,0,0,0,0,0,0],
        [0,0,22,23,23,23,23,23,23,23,23,23,23,24,0,0],
        [0,0,0,0,0,0,0,0,0,0,0,0,0,0,0,0],
        [0,0,22,23,23,23,24,0,0,0,0,0,0,0,0,0],
        [0,0,0,0,0,0,0,22,24,0,23,0,22,24,0,0],
        [0,0,0,22,24,0,0,0,0,0,0,0,0,0,0,0],
        [0,0,0,0,0,0,0,0,0,0,0,0,0,0,0,0],
        [13,13,13,15,0,13,15,0,13,15,0,13,15,0,13,15]
    ],
    [
        [0,0,0,0,0,0,0,0,0,0,0,0,0,0,0,0],
        [0,0,0,0,0,0,0,0,0,0,0,0,0,0,0,0],
        [0,0,0,0,0,0,0,0,0,0,0,0,0,0,0,0],
        [0,0,0,0,0,0,0,0,0,0,0,0,0,0,0,0],
        [0,0,22,23,23,23,23,23,23,23,23,23,23,24,0,0],
        [24,0,0,0,0,0,0,0,0,0,0,0,0,0,0,22],
        [0,0,0,0,0,0,0,0,0,0,0,0,0,0,0,0],
        [24,0,0,0,0,0,0,22,24,0,0,0,0,0,0,22],
        [0,0,0,22,24,0,0,0,0,0,0,0,0,0,0,0],
        [24,0,0,0,0,0,23,0,0,0,0,0,0,0,0,22],
        [0,0,0,0,0,0,0,0,0,0,0,0,0,0,0,0],
        [15,0,13,15,0,13,15,0,13,15,0,13,15,0,13,15]
    ]
] 
}
